,Revenue,COGS,Gross Profit,Gross Profit Ratio,Research and Development Exp.,General and Administrative Exp.,Selling and Marketing Exp.,"Selling, General and Administrative Exp.",Other Expenses,Operating Expenses,COGS and Expenses,Interest Income,Interest Expense (Gain),Depreciation and Amortization,EBITDA,EBITDA Ratio,Operating Income,Operating Income Ratio,Total Other Income Expenses (Gains),Income Before Tax,Income Before Tax Ratio,Income Tax Expense (Gain),Net Income,Net Income Ratio,EPS,EPS Diluted,Weighted Average Shares Outstanding,Weighted Average Shares Outstanding Diluted,Cash and Cash Equivalents,Short-Term Investments,Cash and Short-Term Investments,Net Receivables,Inventory (Balance),Other Current Assets,Total Current Assets,PP&E,Goodwill,Intangible Assets,Goodwill and Intangible Assets,Investments,Tax Assets,Other Non-Current Assets,Total Non-Current Assets,Other Assets,Total Assets,Accounts Payable (Balance),Short-Term Debt,Tax Payable,Deferred Revenue (Current),Other Current Liabilities,Total Current Liabilities,Long-Term Debt,Deferred Revenue (Non-Current),Deferred Tax Liabilities,Other Non-Current Liabilities,Total Non-Current Liabilities,Other Liabilities,Capital Lease Obligations,Total Liabilities,Preferred Stock,Common Stock,Retained Earnings,Other Comprehensive Income/Loss,Other Total Stockholders Equity,Total Stockholders Equity,Total Liabilities And Stockholders Equity,Minority Interest,Total Liabilities & Equity,Net Income (Cash Flow),Depreciation and Amortization (Cash Flow),Deferred Income Tax,Stock Based Compensation,Change in Working Capital,Accounts Receivable,Inventory (Cash Flow),Accounts Payable (Cash Flow),Other Working Capital,Other Non-Cash Items,Cash Provided by Operating Activities,CAPEX,Acquisitions Net,Purchases of Investments,Sales/Maturities of Investments,Other Investing Activities,Cash Used for Investing Activites,Debt Repayment,Common Stock Issued,Common Stock Repurchased,Dividends Paid,Other Financing Activites,Cash Used/Provided by Financing Activities,Effect of Forex Changes on Cash,Net Change In Cash,Cash at the End of Period,Cash at the Beginning of Period,Free Cash Flow
1989,71650000,4120000.0,67530000.0,0.9425,,1200000,,1200000,6050000.0,7250000.0,11370000.0,,-7060000,,-2500000,-0.0349,60280000.0,0.8413,-55720000.0,4560000,0.0636,,4560000,0.0636,0.08,0.08,60730000,60730000,100000.0,,100000.0,293900000,,,,,,,,749000000,,,,1053600000,1053600000,387100000.0,,,,400000.0,,,,,155000000.0,,542500000,,542500000,,600000.0,-57900000.0,5600000.0,562800000.0,511100000,1053600000,,1053600000,4560000,,,,314200000.0,,,,,-4560000.0,314200000,,,,,,,,,,-60900000,-253200000.0,-314100000,,100000.0,100000.0,,314200000
1990,74470000,3870000.0,70600000.0,0.948,,1200000,,1200000,500000.0,1700000.0,5570000.0,,3110000,,72010000,0.967,68900000.0,0.9252,,68900000,0.9252,,68900000,0.9252,1.13,1.13,61220000,61220000,21200000.0,,21200000.0,230000000,,,,,,,,767100000,,,,1026500000,1026500000,505100000.0,,,,700000.0,,,,,1200000.0,,507100000,,507100000,,600000.0,-56800000.0,8700000.0,566900000.0,519400000,1026500000,,1026500000,68900000,,,,81700000.0,,,-118000000.0,,-68900000.0,81700000,,,,,,,,,,-60600000,,-60600000,,21100000.0,21200000.0,100000.0,81700000
1991,70480000,4140000.0,66340000.0,0.9413,,1180000,,1180000,470000.0,1650000.0,5790000.0,,18090000,,139660000,1.9816,64690000.0,0.9178,56880000.0,121570000,1.7249,,121570000,1.7249,1.97,1.97,61820000,61820000,100000.0,,100000.0,237500000,,,,,,,,774100000,,,,1019500000,1019500000,314700000.0,83000000.0,,,,397700000.0,,,,38200000.0,,39000000,,436700000,,600000.0,-17100000.0,27000000.0,572300000.0,582800000,1019500000,,1019500000,121570000,,,,-45900000.0,,,190400000.0,,-121570000.0,-45900000,,,,,,,,,,-58100000,83000000.0,24900000,,-21000000.0,200000.0,21200000.0,-45900000
1992,51710000,4360000.0,47350000.0,0.9157,,1270000,,1270000,310000.0,1580000.0,5940000.0,,-11810000,,14410000,0.2787,45770000.0,0.8851,-19550000.0,26220000,0.5071,,26220000,0.5071,0.42,0.42,62460000,62460000,400000.0,,400000.0,138000000,,,,,,,,813400000,,,,962800000,962800000,120200000.0,168200000.0,,,,288400000.0,,,,117900000.0,,118700000,,407100000,,600000.0,-25700000.0,15200000.0,565600000.0,555700000,962800000,,962800000,26220000,,,,-31500000.0,,,194500000.0,,-26220000.0,-31500000,,,,,,,,,,-53300000,85100000.0,31800000,,200000.0,300000.0,100000.0,-31500000
1993,62700000,4070000.0,58630000.0,0.9351,,1340000,,1340000,370000.0,1710000.0,5780000.0,,-12470000,,31290000,0.499,56920000.0,0.9078,-13160000.0,43760000,0.6979,,43760000,0.6979,0.7,0.7,62850000,62850000,,,,32300000,,,,,,,,814000000,,,,849100000,849100000,199100000.0,74700000.0,,,,273800000.0,,,,24800000.0,,25600000,,299400000,,600000.0,-22700000.0,2800000.0,569100000.0,549800000,849200000,-100000.0,849100000,43760000,,,,142800000.0,,,-78900000.0,,-43760000.0,142800000,,,,,,,,,,-49700000,-93500000.0,-143200000,,-400000.0,,400000.0,142800000
1994,51260000,3800000.0,47460000.0,0.9259,,1270000,,1270000,390000.0,1660000.0,5460000.0,,-73510000,,-118390000,-2.3096,45800000.0,0.8935,-90680000.0,-44880000,-0.8755,,-44880000,-0.8755,-0.71,-0.71,62850000,62850000,400000.0,,400000.0,30500000,,,,,,,,658700000,,,,689500000,689500000,113100000.0,109300000.0,,,,222400000.0,,,,10800000.0,,11500000,,233900000,,600000.0,-43300000.0,-70800000.0,569200000.0,455700000,689600000,-100000.0,689500000,-44880000,,,,15000000.0,,,86000000.0,,44880000.0,15000000,,,,,,,,,,-49200000,34600000.0,-14600000,,400000.0,400000.0,,15000000
1995,36980000,3450000.0,33530000.0,0.9067,,1180000,,1180000,410000.0,1590000.0,5040000.0,,57350000,,130140000,3.5192,31940000.0,0.8637,40850000.0,72790000,1.9684,,72790000,1.9684,1.16,1.16,62850000,62850000,300000.0,,300000.0,66300000,,,,,,,,693800000,,,,760400000,760400000,59700000.0,214400000.0,,,,274100000.0,,,,4300000.0,,5000000,,279100000,,600000.0,-69300000.0,-13400000.0,563400000.0,481300000,760400000,,760400000,72790000,,,,-58100000.0,,,53400000.0,,-72790000.0,-58100000,,,,,,,,,,-47100000,105100000.0,58000000,,,400000.0,400000.0,-58100000
1996,39880000,3490000.0,36390000.0,0.9125,,1200000,,1200000,400000.0,1600000.0,5090000.0,,18750000,,52850000,1.3252,34790000.0,0.8724,-690000.0,34100000,0.8551,,34100000,0.8551,0.54,0.54,62850000,62850000,300000.0,,300000.0,28800000,,,,,,,,665300000,,,,694400000,694400000,9300000.0,204400000.0,,,,213700000.0,,,,2000000.0,,2600000,,216300000,,600000.0,-91200000.0,5300000.0,563400000.0,478100000,694400000,,694400000,34100000,,,,47400000.0,,,50400000.0,,-34100000.0,47400000,,,,,,,,,,-37500000,-10000000.0,-47500000,,-100000.0,200000.0,300000.0,47400000
1997,41110000,3300000.0,37810000.0,0.9197,,1210000,,1210000,350000.0,1560000.0,4860000.0,,20310000,,87810000,2.136,36250000.0,0.8818,31250000.0,67500000,1.6419,,67500000,1.6419,1.07,1.07,62850000,62850000,,,,68600000,,,,,,,,724000000,,,,823800000,823800000,78000000.0,228500000.0,,,,306500000.0,,,,6500000.0,,7100000,,313600000,,600000.0,-79400000.0,25700000.0,563300000.0,510200000,823800000,,823800000,67500000,,,,11000000.0,,,-68700000.0,,-67500000.0,11000000,,,,,,,,,,-35300000,24100000.0,-11200000,,-200000.0,100000.0,300000.0,11000000
1998,44370000,3570000.0,40800000.0,0.9195,,1130000,,1130000,440000.0,1570000.0,5140000.0,,-25470000,,-1270000,-0.0286,39230000.0,0.8842,-15030000.0,24200000,0.5454,,24200000,0.5454,0.39,0.39,62850000,62850000,300000.0,,300000.0,5900000,,,,,,,,693000000,,,,701500000,701500000,1000000.0,198300000.0,,,,199300000.0,,,,2100000.0,,3100000,,202400000,,600000.0,-65100000.0,200000.0,563400000.0,499100000,701500000,,701500000,24200000,,,,66000000.0,,,77000000.0,,-24200000.0,66000000,,,,,,,,,,-35600000,-30200000.0,-65800000,,200000.0,200000.0,,66000000
1999,50930000,3420000.0,47510000.0,0.9328,,1240000,,1240000,210000.0,1450000.0,4870000.0,,-16480000,,-20800000,-0.4084,46060000.0,0.9044,-50380000.0,-4320000,-0.0848,,-4320000,-0.0848,-0.07,-0.07,62850000,62850000,3400000.0,,3400000.0,21500000,,,,,,,,621300000,,,,770800000,770800000,,186500000.0,,,,186500000.0,,,,122000000.0,,124900000,,311400000,,600000.0,-88300000.0,-16300000.0,563400000.0,459400000,770800000,,770800000,-4320000,,,,54700000.0,,,,,-80000.0,50300000,,,,,,,,,,-35400000,-11800000.0,-47200000,,3100000.0,3400000.0,300000.0,50300000
2000,36580000,3220000.0,33360000.0,0.912,,1370000,,1370000,140000.0,1510000.0,4730000.0,,-660000,,29800000,0.8147,31850000.0,0.8707,-1390000.0,30460000,0.8327,,30460000,0.8327,0.48,0.48,62850000,62850000,100000.0,,100000.0,9600000,,,,,,,,511300000,,,,549900000,549900000,,64500000.0,,,,64500000.0,,,,27600000.0,,30800000,,95300000,,600000.0,-92500000.0,-17000000.0,563400000.0,454500000,549800000,100000.0,549900000,30460000,,,,123600000.0,,,,,40000.0,154100000,,,,,,,,,,-35400000,-121900000.0,-157300000,,-3300000.0,100000.0,3400000.0,154100000
2001,39790000,3340000.0,36450000.0,0.9161,,1380000,,1380000,150000.0,1530000.0,4870000.0,,69130000,,156730000,3.9389,34920000.0,0.8776,52680000.0,87600000,2.2016,,87600000,2.2016,1.39,1.39,62850000,62850000,300000.0,,300000.0,9000000,,,,,,,,621800000,,,,633700000,633700000,,118600000.0,,,,118600000.0,,,,7600000.0,,8300000,,126900000,,600000.0,-106100000.0,52200000.0,560100000.0,506800000,633700000,,633700000,87600000,,,,-106200000.0,,,,,,-18600000,,,,,,,,,,-35400000,54200000.0,18800000,,200000.0,300000.0,100000.0,-18600000
2002,67410000,3570000.0,63840000.0,0.947,,1460000,,1460000,200000.0,1660000.0,5230000.0,,-50290000,,-9990000,-0.1482,62180000.0,0.9224,-21880000.0,40300000,0.5978,,40300000,0.5978,0.64,0.64,62870000,62870000,400000.0,,400000.0,26500000,,,,,,,,688200000,,,,732700000,732700000,1500000.0,205800000.0,,,,207300000.0,,,,11100000.0,,14000000,,221300000,,600000.0,-51400000.0,1900000.0,560300000.0,511400000,732700000,,732700000,40300000,,,,-91700000.0,,,,,,-51400000,,,,,,,,,,-35700000,87200000.0,51500000,,100000.0,400000.0,300000.0,-51400000
2003,45060000,4940000.0,40120000.0,0.8904,,1310000,,1310000,170000.0,1480000.0,6420000.0,,-10740000,,-4860000,-0.1079,38640000.0,0.8575,-32760000.0,5880000,0.1305,,5880000,0.1305,0.09,0.09,63390000,63390000,1100000.0,,1100000.0,11600000,,,,,,,,709400000,,,,723300000,723300000,1300000.0,121800000.0,,,,123100000.0,,,,140500000.0,,142900000,,266000000,,600000.0,-88300000.0,-8800000.0,553800000.0,457300000,723300000,,723300000,5880000,,,,138800000.0,13200000.0,,200000.0,,20000.0,144700000,,,,,,,,,,-60000000,-84000000.0,-144000000,,700000.0,1100000.0,400000.0,144700000
2004,38090000,4950000.0,33140000.0,0.87,,1080000,,1080000,110000.0,1190000.0,6140000.0,,-1730000,,20180000,0.5298,31950000.0,0.8388,-10040000.0,21910000,0.5752,,21910000,0.5752,0.34,0.34,63720000,63720000,400000.0,,400000.0,23600000,,,,,,,,671100000,,,,695300000,695300000,9200000.0,223700000.0,,,,232900000.0,,,,17400000.0,,19800000,,252700000,,600000.0,-75800000.0,-10900000.0,528700000.0,442600000,695300000,,695300000,21910000,,,,-88000000.0,-10300000.0,,-7900000.0,,-10000.0,-66100000,,,,,,,,,,-38900000,104300000.0,65400000,,-700000.0,400000.0,1100000.0,-66100000
2005,40160000,10870000.0,29290000.0,0.7293,,1020000,,1020000,120000.0,1140000.0,12010000.0,,-3060000,,6590000,0.1641,28150000.0,0.7009,-18500000.0,9650000,0.2403,,9650000,0.2403,0.15,0.15,63940000,63940000,100000.0,,100000.0,51700000,,,,,,,,663000000,,,,716000000,716000000,70500000.0,149600000.0,,,,220100000.0,,,,74900000.0,,77500000,,297600000,,600000.0,-93800000.0,-14000000.0,525600000.0,418400000,716000000,,716000000,9650000,,,,99700000.0,-29500000.0,,-61300000.0,,-50000.0,109300000,,,,,,,,,,-35500000,-74100000.0,-109600000,,-300000.0,100000.0,400000.0,109300000
2006,29100000,7640000.0,21460000.0,0.7375,,1020000,,1020000,80000.0,1100000.0,8740000.0,,1270000,,24830000,0.8533,20350000.0,0.6993,3210000.0,23560000,0.8096,,23560000,0.8096,0.37,0.37,63940000,63940000,100000.0,,100000.0,20800000,,,,,,,,503600000,,,,585900000,585900000,16600000.0,70700000.0,,,,87300000.0,,,,81000000.0,,84200000,,171500000,,600000.0,-91600000.0,-12700000.0,518200000.0,414500000,586000000,-100000.0,585900000,23560000,,,,82800000.0,29800000.0,,53900000.0,,40000.0,106400000,,,,,,,,,,-27500000,-78900000.0,-106400000,,,100000.0,100000.0,106400000
2007,30470000,10460000.0,20010000.0,0.6567,,980000,,980000,50000.0,1030000.0,11490000.0,,18370000,,45350000,1.4883,18970000.0,0.6226,8010000.0,26980000,0.8855,,26980000,0.8855,0.42,0.42,63940000,63940000,200000.0,,200000.0,302200000,,,,,,,,483500000,,,,808100000,808100000,303400000.0,69300000.0,,,,372700000.0,,,,16100000.0,,17800000,,390500000,,600000.0,-68700000.0,5600000.0,480200000.0,417700000,808200000,-100000.0,808100000,26980000,,,,48500000.0,-282500000.0,,-286800000.0,,-14880000.0,60600000,,,,,,,,,,-23700000,-36800000.0,-60500000,,100000.0,200000.0,100000.0,60600000
2008,22470000,5150000.0,17320000.0,0.7708,,650000,,650000,10000.0,660000.0,5810000.0,,33170000,,75370000,3.3543,16650000.0,0.741,25550000.0,42200000,1.8781,,42200000,1.8781,0.66,0.66,63940000,63940000,100000.0,,100000.0,25300000,,,,,,,,635300000,,,,686800000,686800000,196100000.0,20800000.0,,,,216900000.0,,,,22000000.0,,25800000,,242700000,,600000.0,-76400000.0,41100000.0,478800000.0,444100000,686800000,,686800000,42200000,,,,,276400000.0,,107300000.0,,,42200000,,,,,,,,,,-15800000,,-15800000,,26400000.0,26600000.0,200000.0,42200000
2009,22340000,3790000.0,18550000.0,0.8303,,820000,,820000,50000.0,870000.0,4660000.0,,-34290000,,-4400000,-0.197,17680000.0,0.7914,12210000.0,29890000,1.338,,29890000,1.338,0.47,0.47,63940000,63940000,100000.0,,100000.0,38500000,,,,,,,,845700000,,1100000.0,,1013800000,1013800000,507500000.0,11800000.0,,,,519300000.0,,,,33500000.0,,39000000,,558300000,,,-22800000.0,-1000000.0,479300000.0,455500000,1013800000,,1013800000,29890000,,,,,-14100000.0,,-311400000.0,,10000.0,29900000,,,,,,,,,,-18400000,,-18400000,,11500000.0,11600000.0,100000.0,29900000
2010,17680000,3910000.0,13770000.0,0.7788,,940000,,940000,-20000.0,920000.0,4830000.0,,16120000,,75270000,4.2574,12850000.0,0.7268,46300000.0,59150000,3.3456,,59150000,3.3456,0.93,0.93,63940000,63940000,,,,83300000,,,,,,,,1050200000,,3100000.0,,1348300000,1348300000,685700000.0,55300000.0,,,,741000000.0,,,,52100000.0,,111100000,,852100000,,,1000000.0,16700000.0,478600000.0,496300000,1348400000,-100000.0,1348300000,59150000,,,,,33800000.0,,-178200000.0,,-50000.0,59100000,,,,,,,,,,-18400000,,-18400000,,40700000.0,40800000.0,100000.0,59100000
2011,27340000,4220000.0,23120000.0,0.8456,,950000,,950000,80000.0,1030000.0,5250000.0,,9530000,,43810000,1.6024,22090000.0,0.808,12190000.0,34280000,1.2538,,34280000,1.2538,0.54,0.54,63940000,63940000,100000.0,,100000.0,9500000,,,,,,,,884400000,,10200000.0,,967200000,967200000,171300000.0,241900000.0,,,,413200000.0,,,,39600000.0,,45300000,,458500000,,,500000.0,29700000.0,478600000.0,508800000,967300000,-100000.0,967200000,34280000,,,,,600000.0,,514400000.0,,20000.0,34300000,,,,,,,,,,-21800000,,-21800000,,12500000.0,12500000.0,,34300000
2012,29710000,4020000.0,25690000.0,0.8647,,870000,,870000,40000.0,910000.0,4930000.0,,-8260000,,21140000,0.7115,24770000.0,0.8337,4630000.0,29400000,0.9896,,29400000,0.9896,0.46,0.46,63940000,63940000,,,,41700000,,,,,,,,886700000,,5800000.0,,1073100000,1073100000,407200000.0,138900000.0,,,,546100000.0,,,,11800000.0,,19100000,,565200000,,,8600000.0,20700000.0,478600000.0,507900000,1073100000,,1073100000,29400000,,,,,1400000.0,,-235900000.0,,,29400000,,,,,,,,,,-17600000,-12700000.0,-30300000,,-900000.0,-800000.0,100000.0,29400000
2013,25250000,4000000.0,21250000.0,0.8416,,830000,,830000,50000.0,880000.0,4880000.0,,-29640000,,-38920000,-1.5414,20370000.0,0.8067,-29650000.0,-9280000,-0.3675,,-9280000,-0.3675,-0.15,-0.15,63940000,63940000,,,,189100000,,,,,,,,855700000,,7400000.0,,1058800000,1058800000,427600000.0,149100000.0,,,,576700000.0,,,,7400000.0,,14200000,,590900000,,,-1200000.0,-9400000.0,478500000.0,467900000,1058800000,,1058800000,-9280000,,,,,-184900000.0,,-20400000.0,,-20000.0,-9300000,,,,,,,,,,-30600000,,-30600000,,-39900000.0,-39900000.0,,-9300000
2014,26889580,3653770.0,23235810.0,0.8641,,1074800,,1074800,44880.0,1119680.0,4773450.0,,2491520,,27099170,1.0078,22116130.0,0.8225,2491520.0,24607650,0.9151,,24607650,0.9151,0.38,0.38,63942540,63942540,,,,61993860,,,,,,,,761244500,,9719020.0,,838173500,838173500,152779400.0,206274760.0,,,,359054160.0,,,,6870730.0,,14186830,,373240990,,,-15800190.0,2458260.0,478274440.0,464932510,838173500,,838173500,24607650,,,,,126758140.0,,274820600.0,,,24607650,,,,,,,,,,-27623180,,-27623180,,-3015530.0,-3015530.0,,24607650
2015,25030910,3462550.0,21568360.0,0.8617,,1038890,,1038890,38790.0,1077680.0,4540230.0,,-7485930,,5518820,0.2205,20490680.0,0.8186,-7485930.0,13004750,0.5195,,13004750,0.5195,0.2,0.2,63942540,63942540,,,,35704010,,,,,,,,676479210,,8491310.0,,725284510,725284510,86093120.0,174580090.0,,,,260673210.0,,,,5642160.0,,11995290,,272668500,,,-27421420.0,1775380.0,478262060.0,452616020,725284520,-10.0,725284510,13004750,,,,,26696580.0,,66686280.0,,,13004750,,,,,,,,,,-25321250,,-25321250,,-12316500.0,-12316500.0,,13004750
2016,22770080,3770430.0,18999650.0,0.8344,,1007290,,1007290,37800.0,1045090.0,4815520.0,,-3628270,,10698010,0.4698,17954560.0,0.7885,-3628280.0,14326280,0.6292,,14326280,0.6292,0.22,0.22,63942540,63942540,,,,16525080,,,,,,,,594721780,,7563260.0,,622648170,622648170,14296830.0,153877160.0,,,,168173990.0,,,,5064510.0,,9592060,,177766050,,,-38759440.0,5379500.0,478262060.0,444882120,622648170,,622648170,14326280,,,,,18089540.0,,71796290.0,,,14326280,,,,,,,,,,-22060180,,-22060180,,-7733900.0,-7733900.0,,14326280
2017,7349442,,,,,990893,,990893,77264.0,1068157.0,,21254273.0,1680271,,7961556,1.0833,,,,6281285,0.8547,,6281285,0.8547,0.1,0.1,62812850,62812850,27140.0,,27140.0,98838048,,,,,,,,648339862,,,,751612349,751612349,31537968.0,,,,,,,,,,,320782672,,320782672,,478262054.0,1678462.0,,-49110839.0,430829677,751612349,,751612349,6281285,,,,2462390.0,,,,,-21212823.0,-12469148,,,,,,,,,,-20333600,32829888.0,12496288,,,27140.0,,-12469148
2018,-4760824,,,,,1480214,,1480214,155792.0,1636006.0,,22674248.0,3086646,,-3310184,0.6953,,,,-6396830,1.3436,,-6396830,1.3436,-0.1,-0.1,63968300,63968300,,,,63512247,,,,,,,,591276553,,,,657032023,657032023,1977180.0,,,,,,,,,,,254268949,,254268949,,475902067.0,-224216.0,,-72914777.0,402763074,657032023,,657032023,-6396830,,,,-199186.0,,,,,25429623.0,18833607,,,,,,,,,-854488.0,-20802353,632094.0,-21024747,,-2191140.0,2231260.0,4422400.0,18833607
2019,30589865,,,,,1079837,,1079837,88153.0,1167990.0,,24193420.0,4526848,,33948723,1.1098,,,,29421875,0.9618,,29421875,0.9618,0.46,0.46,63960598,63960598,,,,3990272,,,,,,,,607572565,,,,614203209,614203209,32153580.0,,,,,,,,,,,212487722,,212487722,,465930125.0,,,-64214638.0,401715487,614203209,,614203209,29421875,,,,-103196.0,,,,,8439176.0,37757855,,,,,,,-10782409.0,,,-26335446,,-37117855,,640000.0,2637260.0,1997260.0,37757855
2020,19800082,,,,,929711,,929711,,,,23040795.0,1141112,,19956523,1.0079,,,,18815411,0.9503,,18815411,0.9503,0.04,0.04,63797112,63797112,,,,30592330,,,,,,,,614418101,,,,648912856,648912856,66085338.0,,,,,,,,,,,254717404,,254717404,,461119770.0,,,-66924318.0,394195452,648912856,,648912856,18815411,,,,-327541.0,,,,,27641120.0,46128990,,,,,,,,,,-26335446,-18532364.0,-44867810,,1261180.0,3898440.0,2637260.0,46128990
2021,-6743978,,,,,886426,,886426,79272.0,965698.0,,18588533.0,148705,,-7560971,1.1211,,,,-7709676,1.1432,,-7709676,1.1432,-0.12,-0.12,63797112,63797112,,,,99840828,,,,,,,,646071578,,,,747602927,747602927,171494128.0,,,,,,116229451.0,,,,116229451.0,503080290,,386850839,,454269488.0,-93517400.0,,,360752088,747602927,,747602927,-7709676,,,,-764490.0,,,,,73739553.0,65265387,,,,,,,-41745458.0,,,-25730109,,-67475567,,-2210180.0,1688260.0,3898440.0,65265387
