,Revenue,COGS,Gross Profit,Gross Profit Ratio,Research and Development Exp.,General and Administrative Exp.,Selling and Marketing Exp.,"Selling, General and Administrative Exp.",Other Expenses,Operating Expenses,COGS and Expenses,Interest Income,Interest Expense (Gain),Depreciation and Amortization,EBITDA,EBITDA Ratio,Operating Income,Operating Income Ratio,Total Other Income Expenses (Gains),Income Before Tax,Income Before Tax Ratio,Income Tax Expense (Gain),Net Income,Net Income Ratio,EPS,EPS Diluted,Weighted Average Shares Outstanding,Weighted Average Shares Outstanding Diluted,Cash and Cash Equivalents,Short-Term Investments,Cash and Short-Term Investments,Net Receivables,Inventory (Balance),Other Current Assets,Total Current Assets,PP&E,Goodwill,Intangible Assets,Goodwill and Intangible Assets,Investments,Tax Assets,Other Non-Current Assets,Total Non-Current Assets,Other Assets,Total Assets,Accounts Payable (Balance),Short-Term Debt,Tax Payable,Deferred Revenue (Current),Other Current Liabilities,Total Current Liabilities,Long-Term Debt,Deferred Revenue (Non-Current),Deferred Tax Liabilities,Other Non-Current Liabilities,Total Non-Current Liabilities,Other Liabilities,Capital Lease Obligations,Total Liabilities,Preferred Stock,Common Stock,Retained Earnings,Other Comprehensive Income/Loss,Other Total Stockholders Equity,Total Stockholders Equity,Total Liabilities And Stockholders Equity,Minority Interest,Total Liabilities & Equity,Net Income (Cash Flow),Depreciation and Amortization (Cash Flow),Deferred Income Tax,Stock Based Compensation,Change in Working Capital,Accounts Receivable,Inventory (Cash Flow),Accounts Payable (Cash Flow),Other Working Capital,Other Non-Cash Items,Cash Provided by Operating Activities,CAPEX,Acquisitions Net,Purchases of Investments,Sales/Maturities of Investments,Other Investing Activities,Cash Used for Investing Activites,Debt Repayment,Common Stock Issued,Common Stock Repurchased,Dividends Paid,Other Financing Activites,Cash Used/Provided by Financing Activities,Effect of Forex Changes on Cash,Net Change In Cash,Cash at the End of Period,Cash at the Beginning of Period,Free Cash Flow
2005,10849503,,,,,2787695,,2787695,,,,13678002,3848197,194018,9848924,0.9078,5806709.0,0.5352,,5806709,0.5352,2184803,3621906,0.3338,4.59,4.59,789012,789012,4709890,,4709890,1268377,,,,3812831,,,,19904503,,,,238291437,238291437,319987,,100786.0,,,,40700000,,,,40700000,255423216,,214723216,,7890120,12763903,-6668,2920866,23568221,238291437,,238291437,3621906,194018,-207721,,-374607,,,48906,,461167,3694763,-228327,,-13807221,12502022,-32958117,-34491643,,,,-1167737,32861377,31693640,,896760,6809595,5912835,3466436
2006,11682027,,,,,2932519,,2932519,,,,16106473,5570237,208399,12356199,1.0577,6577563.0,0.563,,6577563,0.563,2461862,4115701,0.3523,5.22,5.22,789012,789012,5990866,,5990866,1445833,,,,3991077,,,,18865774,,,,242304782,242304782,469747,,,,,,43700000,,,,43700000,260397626,,216697626,,7890120,15632965,-836795,2920866,25607156,242304782,,242304782,4115701,208399,-90804,,-462495,,,149760,,194703,3965504,-380374,,-5683998,6501687,-3046932,-2609617,,,,-1246639,546567,-700072,,655815,7465410,6809595,3585130
2007,13199478,,,,,4062905,,4062905,,,,17408822,6654144,298481,13165366,0.9974,6212741.0,0.4707,,6212741,0.4707,2313246,3899495,0.2954,4.96,4.96,786950,786950,5399704,,5399704,1814574,,229860479.0,237074757.0,5901649,,767932.0,767932.0,18063424,,,24733005.0,286540767,261807762,521219,,,,,,53192597,,,,53192597,286960565,,233767968,,7855120,17997286,-733478,2920866,28039794,261807762,,261807762,3899495,298481,-252472,,-9682,,,51472,,526547,4462369,-1657783,-884634.0,-3430021,4002269,-14903275,-16873444,-19978567.0,,-255500.0,-1314674,36334548,14785807,,2374732,9840142,7465410,2804586
2008,12196444,,,,,4288674,,4288674,,,,15557307,5892030,338020,9662937,0.7923,3432887.0,0.2815,,3432887,0.2815,1270010,2162877,0.1773,2.77,2.77,781578,781578,3789925,,3789925,1582688,,225151232.0,230523845.0,6523845,,712932.0,712932.0,14133613,,,21370390.0,273264625,251894235,441832,,,,,,43173216,,,,43173216,266624527,,223451311,,7795120,18370797,-643859,2920866,28442924,251894235,,251894235,2162877,338020,204946,,-481428,,,-79387,,1705146,3929561,-906525,,-2505170,6904811,2518356,6011472,-19381.0,,-480000.0,-1369366,-10225613,-12094360,,-2153327,7686815,9840142,3023036
2009,11927524,,,,,4255384,,4255384,,,,13906368,4607484,418530,7993769,0.6702,2967755.0,0.2488,,2967755,0.2488,1077827,1889928,0.1585,2.42,2.42,779512,779512,15988739,,15988739,1450155,,217744291.0,235183185.0,6521504,,671660.0,671660.0,13091076,,,20284240.0,275751665,255467425,439410,,,,,,28000000,,,,28000000,254577677,,226577677,,7795120,18865399,-691637,2920866,28889748,255467425,,255467425,1889928,418530,-388710,,188759,,,-2422,2470.0,1753859,3862366,-359541,-25344.0,-4049383,5093640,9064404,9723776,-173216.0,,,-1395326,3300135,1731593,,15317735,23004550,7686815,3502825
2010,11341925,,,,,3952737,,3952737,,,,12813926,3777063,422098,3457436,0.3048,-741725.0,-0.0654,,-741725,-0.0654,-368190,-373535,-0.0329,-0.48,-0.48,779512,779512,10378485,,10378485,1360708,,215513140.0,227252333.0,6389781,,603988.0,603988.0,11546313,,,18540082.0,264332497,245792415,414758,,,,,,24000000,,,,24000000,242400251,,218400251,,7795120,17088742,-412564,2920866,27392164,245792415,,245792415,-373535,422098,-1185153,,412472,,,-24652,,5041311,4317193,-235041,,-6022073,7800630,-8294456,-6750940,,,,-1403122,-7773196,-9176318,,-11610065,11394485,23004550,4082152
2011,10993822,,,,,4642136,,4642136,,,,11718660,3181006,396778,402853,0.0366,,,,-3174931,-0.2888,-1187650,-1987281,-0.1808,-2.55,-2.55,779512,779512,27613717,,27613717,1087971,,208640471.0,237342159.0,6186844,,,547932.0,9081293,,,15816069.0,268974297,253158228,345359,,,,,,20000000,,,,20000000,248344307,,228344307,,7795120,14844222,13707,2160872,24813921,253158228,,253158228,-1987281,396778,906027,,-1905728,272737.0,,-159174,,6949143,4358939,-142495,,-7079054,9500946,9139019,11418416,-4000000.0,,,-257239,13717116,9459877,,25237232,36631717,11394485,4216444
